################################################################
#                                                            33#
#                                                           333#
#         11111111111111111111111111111111111514411111     333 #
#       111111111111111111111111111111111111151441111111  333  #
#      11111111111111111111111111111111111111111111111111333   #
#     11111111111111111111111111111111111111111111111111333    #
#    11111111                                     111113331    #
#   1111111                                         1133311    #
#  1111111                                           3331111   #
#  111111                                           33311111   #
# 111111   ##########################################3 111111  #
# 111111   ##########################################   11111  #
# 11111    ##########################################   11111  #
# 11111    ##########################################   11111  #
# 22222    ##########################################   66661  #
# 11111    ##########################################   66666  #
# 11111    ##########################################   16666  #
# 11111    ##########################################   11666  #
# 111111   ##########################################   11111  #
# 111111   ##########################################3 111111  #
#  111111                                           33311111   #
#  1111111                                           3331111   #
#   1111111                                         1133311    #
#   111111111                                     111113331    #
#    111111111441511111111111111111111111111111111111111333    #
#     111111114415111111111111111111111111111111111111111333   #
#      1111111111111111111111111111111111111111111111111  333  #
#        111111111111111111111111111111111111111111111     333 #
#                                                           333#
#                                                            33#
################################################################