################################################################################################################################
################################################################################################################################
################################################################################################################################
################################################################################################################################
################################################################################################################################
#####                                                                                                                     ######
#####                                                                                                                     ######
#####                                                                                                                     ######
#####                                                                                                                     ######
#####                                                                                                                     ######
#####                                                 1111111111111111111                                                 ######
#####                                            11111111511111444111111111111                                            ######
#####                                         11111111115511144444441111111111111                                         ######
#####                                      11111111111155511144444441111111111111111                                      ######
#####                                    111111111111155551144444444411111111111111111                                    ######
#####                                  1111111111111115555114444444441111111111111111111                                  ######
#####                                11111111111111111555511444444444111111111111111111111                                ######
#####                              111111111111111111155511114444444111111111111111111111111                              ######
#####                             11111111111111111111551111144444441111111111111111111111111                             ######
#####                           111111111111111111111151111111144411111111111111111111111111111                           ######
#####                          11111111111111111111111111111111111111111111111111111111111111111                          ######
#####                         1111111111111111111111111111111111111111111111111111111111111111111                         ######
#####                        111111111111111111111111111111111111111111111111111111111111111111111                        ######
#####                      1111111111111111111111111111111111111111111111111111111111111111111111111                      ######
#####                     111111111111111111111111111111111111111111111111111111111111111111111111111                     ######
#####                    11111111111111111111111111111111111       11111111111111111111111111111111111                    ######
#####                   111111111111111111111111111111                  1111111111111111111111111111111                   ######
#####                  1111111111111111111111111111                         1111111111111111111111111111                  ######
#####                  1111111111111111111111111                               1111111111111111111111111                  ######
#####                 111111111111111111111111                                   111111111111111111111111                 ######
#####                11111111111111111111111                                       11111111111111111111111                ######
#####               11111111111111111111111                                         11111111111111111111111               ######
#####              1111111111111111111111                                             1111111111111111111111              ######
#####              111111111111111111111                                               111111111111111111111              ######
#####             111111111111111111111                                                 111111111111111111111             ######
#####            111111111111111111111                                                   111111111111111111111            ######
#####            11111111111111111111                                                     11111111111111111111            ######
#####           11111111111111111111                                                       11111111111111111111           ######
#####           1111111111111111111                                                         1111111111111111111           ######
#####          1111111111111111111                                                           1111111111111111111          ######
#####          111111111111111111                                                             111111111111111111          ######
#####         111111111111111111           ###########################################         111111111111111111         ######
#####         111111111111111111           ###########################################         111111111111111111         ######
#####        111111111111111111            ###########################################          111111111111111111        ######
#####        11111111111111111             ###########################################           11111111111111111        ######
#####        11111111111111111             ###########################################           11111111111111111        ######
#####       11111111111111111              ###########################################            11111111111111111       ######
#####       11111111111111111              ###########################################            11111111111111111       ######
#####       1111111111111111               ###########################################             1111111111111111       ######
#####      11111111111111111               ###########################################             11111111111111111      ######
#####      11111111111111111               ###########################################             11111111111111111      ######
#####      1111111111111111                ###########################################              1111111111111111      ######
#####      1111111111111111                ###########################################              1111111111111111      ######
#####      1111111111111111                ###########################################              1111111111111111      ######
#####     1111111111111111                 ###########################################               1111111111111111     ######
#####     1111111111111111                 ###########################################               1111111111111111     ######
#####     1111111111111111                 ###########################################               1111111111111111     ######
#####     1111111111111111                 ###########################################               1111111111111111     ######
#####     1111111111111111                 ###########################################               1111111111111111     ######
#####     1111111111111111                 ###########################################               1111666666111111     ######
#####     111111111111111                  ###########################################                166666666666111     ######
#####     111111111111111                  ###########################################                666666666666611     ######
#####     111111111111111                  ###########################################                666666666666661     ######
#####     222222222222222                  ###########################################                666666666666661     ######
#####     222222222222222                  ###########################################              66666666666666661     ######
#####     222222222222222                  ###########################################              66666666666666661     ######
#####     111111111111111                  ###########################################              66666666666666661     ######
#####     1111111111111111                 ###########################################               6666666666666666     ######
#####     1111111111111111                 ###########################################               1116666666666666     ######
#####     1111111111111111                 ###########################################               1116666666666666     ######
#####     1111111111111111                 ###########################################               1116666666666666     ######
#####     1111111111111111                 ###########################################               1116666666666666     ######
#####     1111111111111111                 ###########################################               1111666666666661     ######
#####      1111111111111111                ###########################################              1111116666666666      ######
#####      1111111111111111                ###########################################              1111111166666661      ######
#####      1111111111111111                ###########################################              1111111111111111      ######
#####      11111111111111111               ###########################################             11111111111111111      ######
#####      11111111111111111               ###########################################             11111111111111111      ######
#####       1111111111111111               ###########################################             1111111111111111       ######
#####       11111111111111111              ###########################################            11111111111111111       ######
#####       11111111111111111              ###########################################            11111111111111111       ######
#####        11111111111111111             ###########################################           11111111111111111        ######
#####        11111111111111111             ###########################################           11111111111111111        ######
#####        111111111111111111            ###########################################          111111111111111111        ######
#####         111111111111111111                                                               111111111111111111         ######
#####         111111111111111111                                                               111111111111111111         ######
#####          111111111111111111                                                             111111111111111111          ######
#####          1111111111111111111                                                           1111111111111111111          ######
#####           1111111111111111111                                                         1111111111111111111           ######
#####           11111111111111111111                                                       11111111111111111111           ######
#####            11111111111111111111                                                     11111111111111111111            ######
#####            111111111111111111111                                                   111111111111111111111            ######
#####             111111111111111111111                                                 111111111111111111111             ######
#####              111111111111111111111                                               111111111111111111111              ######
#####              1111111111111111111111                                             1111111111111111111111              ######
#####               11111111111111111111111                                         11111111111111111111111               ######
#####                11111111111111111111111                                       11111111111111111111111                ######
#####                 111111111111111111111111                                   111111111111111111111111                 ######
#####                  1111111111111111111111111                               1111111111111111111111111                  ######
#####                  1111111111111111111111111111                         1111111111111111111111111111                  ######
#####                   111111111111111111111111111111                   111111111111111111111111111111                   ######
#####                    11111111111111111111111111111111111       11111111111111111111111111111111111                    ######
#####                     111111111111111111111111111111111111111111111111111111111111111111111111111                     ######
#####                      1111111111111111111111111111111144411111511111111111111111111111111111111                      ######
#####                        111111111111111111111111111144444441115511111111111111111111111111111                        ######
#####                         1111111111111111111111111114444444111555111111111111111111111111111                         ######
#####                          11111111111111111111111114444444441155551111111111111111111111111                          ######
#####                           111111111111111111111111444444444115555111111111111111111111111                           ######
#####                             11111111111111111111114444444441155551111111111111111111111                             ######
#####                              111111111111111111111144444441111555111111111111111111111                              ######
#####                                11111111111111111111444444411111551111111111111111111                                ######
#####                                  1111111111111111111144411111111511111111111111111                                  ######
#####                                    111111111111111111111111111111111111111111111                                    ######
#####                                      11111111111111111111111111111111111111111                                      ######
#####                                         11111111111111111111111111111111111                                         ######
#####                                            11111111111111111111111111111                                            ######
#####                                                 1111111111111111111                                                 ######
#####                                                                                                                     ######
#####                                                                                                                     ######
#####                                                                                                                     ######
#####                                                                                                                     ######
#####                                                                                                                     ######
#####                                                                                                                     ######
################################################################################################################################
################################################################################################################################
################################################################################################################################
################################################################################################################################
#########################################################################################2######################################
